,学院类别,学院名称,年级,学生总数,男生数量,女生数量
0,工学院,人工智能学院,学士,100,60,40
1,工学院,人工智能学院,硕士,130,70,60
2,工学院,信息学院,学士,110,69,41
3,工学院,信息学院,硕士,140,70,70
4,工学院,材料学院,学士,130,80,50
5,工学院,材料学院,硕士,150,70,80
6,理学院,数学学院,学士,90,70,20
7,理学院,数学学院,硕士,100,70,30
8,理学院,物理学院,学士,90,60,30
9,理学院,物理学院,硕士,90,50,40
10,文学院,中文学院,学士,100,40,60
11,文学院,中文学院,硕士,90,30,60
12,文学院,外语学院,学士,110,40,70
13,文学院,外语学院,硕士,90,30,60
